############
#          #
#   PX  O  #
#          #
############
